Level 04 - Easy
    #####
    #   #
    #$  #
  ###  $###
  #  $  $ #
### # ### #     ######
#   # ### #######  xx#
# $  $             xx#
##### #### #@####  xx#
    #      ###  ######
    ########