########
#      #
#      #
#  $   #
#    @ #
#  x   #
#      #
########