Level 08 - Hard
#############
##          #
# $######## #####
#  $     #xxxxxx#
#  $@$ # $xxx#xx#
## ###$$ #xxxxxx#
#####    #xxxxx #
#####$ ### ######
 #            #
 ## $ ####$ # #
 #  $$ # $  $ #
 # $$  # $#$  #
 #  $$ #  $ $ #
 ##    ##     #
 ##############