#######
#  @  #
#  $###
#  x  #
#######