Level 07 - Medium
############
#xx  #     ### 
#xx  # $  $  #
#xx  # ####  #
#xx      ##  #
#    #    ## #
###### ##$$  #
  # $  $ $ $ #
  #       @  #
  ############