Level 06 - Medium
########
#xx    #
#xx$ $ #
#$#$$$##
#xx$ $@#
#xx    #
########
