Level 10 - Invalid (level width)
#############################################
#  #   #
#  $ xx#
#xxx$$ #
#$ # $ #
#@$ $$ #
#  #xx #
########