############
####    ####
#  #$   ####
# $$       #
#@  #$  $# #
### #    # #
##  ###### #
##   xxxxx #
############