Level 03 - Easy
  #####
###   #
#x@$  #
### $x#
#x##$ #
# # x ##
#$x$$$x#
#   x  #
########