Level 05 - Medium
   ######
####    #
#  #$   ####
# $$       #
#@  #$  $# #
 ## #    # #
 #  ###### #
 #   xxxxx #
 ###########