Level 09 - Hard
 ##### #####
 #   ###   #
 # #$$ $$$ #
 # # # # # #
 #x    # # #
##x #### # #
# x  x   x #
# @  #######
######